╔═════════════
║                                                   
║.╔═════════╦═══════╦═════════╦═════════╦══════════╗ 
║.║  .........      ║         ║         ║          ║
║.║  .╔═╗ ╚═╗.║ ╔═╝ ║ ╔═════╗ ╚═╗ ║ ╔═╝ ║ ╠═╣ ║    ║
║.║...║ ║   ║.║ ╚═╗ ║ ║     ║   ║ ║     ║     ║    ║
║.║.╔═╝ ╚═╗ ║.║   ║ ║ ║ ╔═╝ ║ ╔═╝ ╚═══╝ ╚═══╗ ║    ║
║.║.║     ║ ║.║ ╔═╝ ║ ║     ║                 ║    ║
║.║.║ ╔═╗ ║ ║.║ ║   ║ ╚═══╝ ║ ╔═════════════╗ ║    ║
║.║.║ ╚═╝ ║ ║.║ ╚═══╝  ╦╦╦╦   ║               ║ ║  ║
║.║.║     ║ ║.║        ╩╩╩╩   ║ ╔═════════════╝ ║  ║
║.║.║ ╔═══╝ ║.║        ╬╬╬╬   ║ ║                  ║
║.║.║       ║.╚═════════════╦═╣ ║ ╔═══════════════╦╣ 
║.║.╚═════╗ ║.              ║ ║ ║...              ║║
║.║.        ║.╚═════════════╝ ║ ║.║.╔═══════════╗ ║║
║.║.╔═══════╝.                ║ ║.║.║           ║ ║║
║.║.║.........                ║ ║.║.║ ╚═════════╝ ║║
║.║.║.╔═══════════════════════╝ ║.║.║             ║║
║.║.║.║                         ║.║.║             ║║
║.║.║.╚═════════════════════════╝.║.╚══════    ═══╝║ 
║...║.............................║..............  ║
╚═══╩═════════════════════════════╩═══════════  F  ╝